20
7
6 6 6 6 6 6 6 6 6 6 6 6 6 6 6 6 6 6 6 6
6 6 6 6 6 6 6 6 6 6 6 6 6 6 6 6 6 6 6 6
4 6 6 6 6 6 6 6 4 6 6 6 6 6 6 6 6 6 6 6
8 6 6 6 2 3 6 6 8 6 6 6 6 6 6 6 6 6 6 6
7 6 1 6 9 10 6 1 7 6 6 6 6 6 6 6 6 6 6 6
1 1 1 1 1 1 1 1 1 1 1 1 1 1 1 1 1 1 1 1
0 0 0 0 0 0 0 0 0 0 0 0 0 0 0 0 0 0 0 0